########################
#      #          #    #
#                 #  * #
#      #    M     #    #
#      #               #
### ####################
#     # M         #    #
# #####  #######  #    #
# #      #             #
# # ###  #  M       @  #
#   #    #             #
########################
