#############################################################
# *   #                 #              #     #     #        #
####  #  ####  #######  #  ##########  #  #  ####  #  ####  #
#     #  #     #        #           #  #  #        #  #     #
#  #######  ####  ################  #  #  ##########  #  #  #
#        #     #  #           #     #     #     #     #  #  #
#  ####  ####  #  #  ##########  #######  #  #  #######  #  #
#     #     #  #           #     #     #     #     M     #  #
####  #  ####  ####  ####  #  ####  #  ###################  #
#     #     #  #  #  #  #        #  #  #           #     #  #
#  #  ####  #  #  #  #  ##########  #  #  #######  #  ####  #
#  #     #     #     #        #     #     #        #  #     #
#######  #######  ##########  #  #  #######  #######  #  ####
#     #     #  #     #  #     #  #  #        #     #     #  #
#  #######  #  ####  #  #  ####  #  #  #######  #  #######  #
#       M   #     #     #        #  #        #  #           #
#  #############  ####  ##########  ####  ####  ##########  #
#     #     #           #           #  #        #           #
####  ####  #  #  ################  #  ##########  #######  #
#           #  #          M         #              #      @ #
#############################################################
